0000,0000,0000,0000,0000,0000,0615,enemy_001,0000,0000,0000,0000,0000,0000,0000,0000,0000,0000,0000,0000,0000,0000,0000,0000,0000,0000,0000,0000,0000,0000,0000,0000,0000,0000,0000,0000,0000,0000,0000,0000,0000,0000,0000,0000,0615,enemy_001,0000,0000,0000,
0608,0708,0708,0708,0708,0708,0708,0708,0609,0000,0000,0000,0000,0000,0000,0000,0000,0000,0000,0000,0000,0000,0000,0000,0000,0000,0000,0000,0000,0000,0000,0000,0000,0000,0000,0000,0000,0000,0000,0000,0000,0000,0000,0000,0000,0608,0708,0708,0708,0708,0609,
0000,0000,0000,0000,0000,0000,0000,0000,0000,0000,0000,0000,0000,0000,0000,0000,0000,0000,0000,0000,0000,0000,0000,0000,0000,0000,0000,0000,0000,0000,0000,0000,0000,0000,0000,0000,0000,0000,0000,0000,0000,0000,0000,0000,0000,0000,0000,0000,0000,0000,0000,
0000,0000,0000,0000,0000,0000,0000,0000,0000,0000,0000,0000,0000,0000,0000,0000,0000,0000,0000,0000,0000,0000,0000,0000,0000,0000,0000,0000,0000,0000,0000,0000,0000,0000,0000,0000,0000,0000,0000,0000,0000,0000,0000,0000,0000,0000,0000,0000,0000,0000,0000,
0000,0000,0000,0000,0000,0000,0000,0000,0000,0000,0000,0000,0000,0000,0000,0000,0000,0000,0000,0000,0000,0000,0000,0000,0000,0000,0000,0000,0000,0000,0000,0000,0000,0000,0000,0000,0000,0000,0000,0000,0000,0000,0000,0000,0000,0000,0000,0000,0000,0000,0000,
0000,0000,0000,0000,0000,0000,0000,0000,0000,0000,0000,0000,0000,0000,0000,0000,0000,0000,0000,0000,0000,0000,0000,0000,0000,0000,0000,0000,0000,0000,0000,0000,0000,0000,0000,0000,0000,0000,0000,0000,0000,0000,0000,0000,0000,0000,0000,0000,0000,0000,0000,
0707,0708,0708,0708,0708,0708,0708,0708,0708,0708,0708,0708,0708,0708,0708,0708,0708,0708,0708,0708,0708,0708,0708,0708,0708,0708,0708,0708,0708,0708,0708,0708,0708,0708,0708,0708,0708,0708,0708,0708,0708,0708,0708,0708,0708,0708,0708,0708,0708,0708,0709,
0607,0607,0607,0607,0607,0607,0607,0607,0607,0607,0607,0607,0607,0607,0607,0607,0607,0607,0607,0607,0607,0607,0607,0607,0607,0607,0607,0607,0607,0607,0607,0607,0607,0607,0607,0607,0607,0607,0607,0607,0607,0607,0607,0607,0607,0607,0607,0607,0607,0607,0607,
0607,0607,0607,0607,0607,0607,0607,0607,0607,0607,0607,0607,0607,0607,0607,0607,0607,0607,0607,0607,0607,0607,0607,0607,0607,0607,0607,0607,0607,0607,0607,0607,0607,0607,0607,0607,0607,0607,0607,0607,0607,0607,0607,0607,0607,0607,0607,0607,0607,0607,0607,
0607,0607,0607,0607,0607,0607,0607,0607,0607,0607,0607,0607,0607,0607,0607,0607,0607,0607,0607,0607,0607,0607,0607,0607,0607,0607,0607,0607,0607,0607,0607,0607,0607,0607,0607,0607,0607,0607,0607,0607,0607,0607,0607,0607,0607,0607,0607,0607,0607,0607,0607,